Psalm 3	A Psalm of David, when he fled from Absalom his son.
Psalm 4	To the chief Musician on Neginoth, A Psalm of David.
Psalm 5	To the chief Musician upon Nehiloth, A Psalm of David.
Psalm 6	To the chief Musician on Neginoth upon Sheminith, A Psalm of David.
Psalm 7	Shiggaion of David, which he sang unto the LORD, concerning the words
Psalm 8	To the chief Musician upon Gittith, A Psalm of David.
Psalm 9	To the chief Musician upon Muthlabben, A Psalm of David.
Psalm 11	To the chief Musician, A [Psalm] of David.
Psalm 12	To the chief Musician upon Sheminith, A Psalm of David.
Psalm 13	To the chief Musician, A Psalm of David.
Psalm 14	To the chief Musician, A [Psalm] of David.
Psalm 15	A Psalm of David.
Psalm 16	Michtam of David.
Psalm 17	A Prayer of David.
Psalm 18	To the chief Musician, A [Psalm] of David, the servant of the LORD, who
Psalm 19	To the chief Musician, A Psalm of David.
Psalm 20	To the chief Musician, A Psalm of David.
Psalm 21	To the chief Musician, A Psalm of David.
Psalm 22	To the chief Musician upon Aijeleth Shahar, A Psalm of David.
Psalm 23	A Psalm of David.
Psalm 24	A Psalm of David.
Psalm 25	A [Psalm] of David.
Psalm 26	A [Psalm] of David.
Psalm 27	A [Psalm] of David.
Psalm 28	A [Psalm] of David.
Psalm 29	A Psalm of David.
Psalm 30	A Psalm [and] Song [at] the dedication of the house of David.
Psalm 31	To the chief Musician, A Psalm of David.
Psalm 32	A [Psalm] of David, Maschil.
Psalm 34	A [Psalm] of David, when he changed his behaviour before Abimelech; who
Psalm 35	A [Psalm] of David.
Psalm 36	To the chief Musician, A [Psalm] of David, the servant of the LORD.
Psalm 37	A [Psalm] of David.
Psalm 38	A Psalm of David, to bring to remembrance.
Psalm 39	To the chief Musician, [even] to Jeduthun, A Psalm of David.
Psalm 40	To the chief Musician, A Psalm of David.
Psalm 41	To the chief Musician, A Psalm of David.
Psalm 42	To the chief Musician, Maschil, for the sons of Korah.
Psalm 44	To the chief Musician for the sons of Korah, Maschil.
Psalm 45	To the chief Musician upon Shoshannim, for the sons of Korah, Maschil,
Psalm 46	To the chief Musician for the sons of Korah, A Song upon Alamoth.
Psalm 47	To the chief Musician, A Psalm for the sons of Korah.
Psalm 48	A Song [and] Psalm for the sons of Korah.
Psalm 49	To the chief Musician, A Psalm for the sons of Korah.
Psalm 50	A Psalm of Asaph.
Psalm 51	To the chief Musician, A Psalm of David, when Nathan the prophet came
Psalm 52	To the chief Musician, Maschil, A [Psalm] of David, when Doeg the
Psalm 53	To the chief Musician upon Mahalath, Maschil, A [Psalm] of David.
Psalm 54	To the chief Musician on Neginoth, Maschil, A [Psalm] of David, when
Psalm 55	To the chief Musician on Neginoth, Maschil, A [Psalm] of David.
Psalm 56	To the chief Musician upon Jonathelemrechokim, Michtam of David, when
Psalm 57	To the chief Musician, Altaschith, Michtam of David, when he fled from
Psalm 58	To the chief Musician, Altaschith, Michtam of David.
Psalm 59	To the chief Musician, Altaschith, Michtam of David; when Saul sent,
Psalm 60	To the chief Musician upon Shushan-eduth, Michtam of David, to teach;
Psalm 61	To the chief Musician upon Neginah, A [Psalm] of David.
Psalm 62	To the chief Musician, to Jeduthun, A Psalm of David.
Psalm 63	A Psalm of David, when he was in the wilderness of Judah.
Psalm 64	To the chief Musician, A Psalm of David.
Psalm 65	To the chief Musician, A Psalm [and] Song of David.
Psalm 66	To the chief Musician, A Song [or] Psalm.
Psalm 67	To the chief Musician on Neginoth, A Psalm [or] Song.
Psalm 68	To the chief Musician, A Psalm [or] Song of David.
Psalm 69	To chief Musician upon Shoshannim, A [Psalm] of David.
Psalm 70	To the chief Musician, A [Psalm] of David, to bring to remembrance.
Psalm 72	A [Psalm] for Solomon.
Psalm 73	A Psalm of Asaph.
Psalm 74	Maschil of Asaph.
Psalm 75	To the chief Musician, Altaschith, A Psalm [or] Song of Asaph.
Psalm 76	To the chief Musician on Neginoth, A Psalm [or] Song of Asaph.
Psalm 77	To the chief Musician, to Jeduthun, A Psalm of Asaph.
Psalm 78	Maschil of Asaph.
Psalm 79	A Psalm of Asaph.
Psalm 80	To the chief Musician upon Shoshannim-Eduth, A Psalm of Asaph.
Psalm 81	To the chief Musician upon Gittith, a Psalm of Asaph.
Psalm 82	A Psalm of Asaph.
Psalm 83	A Song [or] Psalm of Asaph.
Psalm 84	To the chief Musician upon Gittith, A Psalm for the sons of Korah.
Psalm 85	To the chief Musician, A Psalm for the sons of Korah.
Psalm 86	A Prayer of David.
Psalm 87	A Psalm [or] Song for the sons of Korah.
Psalm 88	A Song [or] Psalm for the sons of Korah, to the chief Musician upon
Psalm 89	Maschil of Ethan the Ezrahite.
Psalm 90	A Prayer of Moses the man of God.
Psalm 92	A Psalm [or] Song for the sabbath day.
Psalm 98	A Psalm.
Psalm 100	A Psalm of praise.
Psalm 101	A Psalm of David.
Psalm 102	A Prayer of the afflicted, when he is overwhelmed, and poureth out his
Psalm 103	A [Psalm] of David.
Psalm 108	A Song [or] Psalm of David.
Psalm 109	To the chief Musician, A Psalm of David.
Psalm 110	A Psalm of David.
Psalm 119	ALEPH.
Psalm 120	A Song of degrees.
Psalm 121	A Song of degrees.
Psalm 122	A Song of degrees of David.
Psalm 123	A Song of degrees.
Psalm 124	A Song of degrees of David.
Psalm 125	A Song of degrees.
Psalm 126	A Song of degrees.
Psalm 127	A Song of degrees for Solomon.
Psalm 128	A Song of degrees.
Psalm 129	A Song of degrees.
Psalm 130	A Song of degrees.
Psalm 131	A Song of degrees of David.
Psalm 132	A Song of degrees.
Psalm 133	A Song of degrees of David.
Psalm 134	A Song of degrees.
Psalm 138	A [Psalm] of David.
Psalm 139	To the chief Musician, A Psalm of David.
Psalm 140	To the chief Musician, A Psalm of David.
Psalm 141	A Psalm of David.
Psalm 142	Maschil of David; A Prayer when he was in the cave.
Psalm 143	A Psalm of David.
Psalm 144	A [Psalm] of David.
Psalm 145	David's [Psalm] of praise.
